************
S  *   *   *
** * * * * *
*    * * * *
****** * * *
*      * * *
* ****** * *
* *      * *
* * ****** *
* * * *    *
*   *   ** F
************